"filename", "language", "JSON", "TypeScript", "comment", "blank", "total"
"c:\Users\Dodo\Desktop\Projeler\smartmoles-nest-backend\package-lock.json", "JSON", 82, 0, 0, 0, 82
"c:\Users\Dodo\Desktop\Projeler\smartmoles-nest-backend\package.json", "JSON", 2, 0, 0, 0, 2
"c:\Users\Dodo\Desktop\Projeler\smartmoles-nest-backend\src\app.module.ts", "TypeScript", 0, 8, 0, 1, 9
"c:\Users\Dodo\Desktop\Projeler\smartmoles-nest-backend\src\core\abstracts\data-services.abstract.ts", "TypeScript", 0, 2, 0, 0, 2
"c:\Users\Dodo\Desktop\Projeler\smartmoles-nest-backend\src\core\dtos\logger\logger.dto.ts", "TypeScript", 0, 9, 0, 2, 11
"c:\Users\Dodo\Desktop\Projeler\smartmoles-nest-backend\src\core\entities\index.ts", "TypeScript", 0, 1, 1, 1, 3
"c:\Users\Dodo\Desktop\Projeler\smartmoles-nest-backend\src\core\entities\logger\logger.models.ts", "TypeScript", 0, 9, 0, 1, 10
"c:\Users\Dodo\Desktop\Projeler\smartmoles-nest-backend\src\frameworks\data-services\mongo\model\index.ts", "TypeScript", 0, 1, 1, 1, 3
"c:\Users\Dodo\Desktop\Projeler\smartmoles-nest-backend\src\frameworks\data-services\mongo\model\logger\logger.model.ts", "TypeScript", 0, 20, 1, 4, 25
"c:\Users\Dodo\Desktop\Projeler\smartmoles-nest-backend\src\frameworks\data-services\mongo\mongo-data-services.module.ts", "TypeScript", 0, 3, 0, 0, 3
"c:\Users\Dodo\Desktop\Projeler\smartmoles-nest-backend\src\frameworks\data-services\mongo\mongo-data-services.ts", "TypeScript", 0, 6, 0, 0, 6
"c:\Users\Dodo\Desktop\Projeler\smartmoles-nest-backend\src\libs\middlewares\loggers\logger.middleware.ts", "TypeScript", 0, 25, 0, 2, 27
"c:\Users\Dodo\Desktop\Projeler\smartmoles-nest-backend\src\main.ts", "TypeScript", 0, 1, 0, 0, 1
"c:\Users\Dodo\Desktop\Projeler\smartmoles-nest-backend\src\operations\cronTest\cronTest.ts", "TypeScript", 0, 11, 0, 3, 14
"c:\Users\Dodo\Desktop\Projeler\smartmoles-nest-backend\src\operations\cronTest\dynamicCron.ts", "TypeScript", 0, 108, 0, 24, 132
"c:\Users\Dodo\Desktop\Projeler\smartmoles-nest-backend\src\operations\cronTest\testFunc.ts", "TypeScript", 0, 23, 2, 6, 31
"c:\Users\Dodo\Desktop\Projeler\smartmoles-nest-backend\src\services\uses-cases\logger\logger-factory.service.ts", "TypeScript", 0, 16, 0, 3, 19
"c:\Users\Dodo\Desktop\Projeler\smartmoles-nest-backend\src\services\uses-cases\logger\logger.module.ts", "TypeScript", 0, 10, 0, 2, 12
"c:\Users\Dodo\Desktop\Projeler\smartmoles-nest-backend\src\services\uses-cases\logger\logger.service.ts", "TypeScript", 0, 18, 0, 4, 22
"Total", "-", 84, 271, 5, 54, 414