"filename", "language", "JSON with Comments", "JavaScript", "TypeScript", "JSON", "Markdown", "comment", "blank", "total"
"c:\Users\Dodo\Desktop\Projeler\smartmoles-nest-backend\.eslintrc.js", "JavaScript", 0, 24, 0, 0, 0, 0, 1, 25
"c:\Users\Dodo\Desktop\Projeler\smartmoles-nest-backend\.prettierrc", "JSON", 0, 0, 0, 4, 0, 0, 0, 4
"c:\Users\Dodo\Desktop\Projeler\smartmoles-nest-backend\README.md", "Markdown", 0, 0, 0, 0, 51, 2, 21, 74
"c:\Users\Dodo\Desktop\Projeler\smartmoles-nest-backend\nest-cli.json", "JSON", 0, 0, 0, 4, 0, 0, 1, 5
"c:\Users\Dodo\Desktop\Projeler\smartmoles-nest-backend\package-lock.json", "JSON", 0, 0, 0, 17021, 0, 0, 1, 17022
"c:\Users\Dodo\Desktop\Projeler\smartmoles-nest-backend\package.json", "JSON", 0, 0, 0, 79, 0, 6, 0, 85
"c:\Users\Dodo\Desktop\Projeler\smartmoles-nest-backend\src\app.controller.spec.ts", "TypeScript", 0, 0, 18, 0, 0, 0, 5, 23
"c:\Users\Dodo\Desktop\Projeler\smartmoles-nest-backend\src\app.controller.ts", "TypeScript", 0, 0, 11, 0, 0, 1, 3, 15
"c:\Users\Dodo\Desktop\Projeler\smartmoles-nest-backend\src\app.module.ts", "TypeScript", 0, 0, 119, 0, 0, 3, 4, 126
"c:\Users\Dodo\Desktop\Projeler\smartmoles-nest-backend\src\app.service.ts", "TypeScript", 0, 0, 7, 0, 0, 0, 2, 9
"c:\Users\Dodo\Desktop\Projeler\smartmoles-nest-backend\src\controllers\callList.controller.ts", "TypeScript", 0, 0, 63, 0, 0, 0, 8, 71
"c:\Users\Dodo\Desktop\Projeler\smartmoles-nest-backend\src\controllers\card.controller.ts", "TypeScript", 0, 0, 44, 0, 0, 0, 7, 51
"c:\Users\Dodo\Desktop\Projeler\smartmoles-nest-backend\src\controllers\centralUnit\centralUnit.controller.ts", "TypeScript", 0, 0, 66, 0, 0, 0, 8, 74
"c:\Users\Dodo\Desktop\Projeler\smartmoles-nest-backend\src\controllers\centralUnit\hubGroups.controller.ts", "TypeScript", 0, 0, 69, 0, 0, 0, 8, 77
"c:\Users\Dodo\Desktop\Projeler\smartmoles-nest-backend\src\controllers\centralUnit\khas.controller.ts", "TypeScript", 0, 0, 73, 0, 0, 0, 11, 84
"c:\Users\Dodo\Desktop\Projeler\smartmoles-nest-backend\src\controllers\centralUnit\pumpKhas.controller.ts", "TypeScript", 0, 0, 61, 0, 0, 0, 9, 70
"c:\Users\Dodo\Desktop\Projeler\smartmoles-nest-backend\src\controllers\centralUnit\valveCard.controller.ts", "TypeScript", 0, 0, 65, 0, 0, 0, 8, 73
"c:\Users\Dodo\Desktop\Projeler\smartmoles-nest-backend\src\controllers\contracts\contractType.controller.ts", "TypeScript", 0, 0, 67, 0, 0, 0, 8, 75
"c:\Users\Dodo\Desktop\Projeler\smartmoles-nest-backend\src\controllers\contracts\userContract.controller.ts", "TypeScript", 0, 0, 72, 0, 0, 0, 10, 82
"c:\Users\Dodo\Desktop\Projeler\smartmoles-nest-backend\src\controllers\hardwares\deviceTypes.controller.ts", "TypeScript", 0, 0, 66, 0, 0, 0, 7, 73
"c:\Users\Dodo\Desktop\Projeler\smartmoles-nest-backend\src\controllers\hardwares\devices.controller.ts", "TypeScript", 0, 0, 62, 0, 0, 0, 7, 69
"c:\Users\Dodo\Desktop\Projeler\smartmoles-nest-backend\src\controllers\hardwares\hardwares.controller.ts", "TypeScript", 0, 0, 61, 0, 0, 0, 8, 69
"c:\Users\Dodo\Desktop\Projeler\smartmoles-nest-backend\src\controllers\hardwares\irrigationTypes.controller.ts", "TypeScript", 0, 0, 68, 0, 0, 0, 8, 76
"c:\Users\Dodo\Desktop\Projeler\smartmoles-nest-backend\src\controllers\hardwares\modem.controller.ts", "TypeScript", 0, 0, 61, 0, 0, 0, 9, 70
"c:\Users\Dodo\Desktop\Projeler\smartmoles-nest-backend\src\controllers\hardwares\simCard.controller.ts", "TypeScript", 0, 0, 61, 0, 0, 4, 9, 74
"c:\Users\Dodo\Desktop\Projeler\smartmoles-nest-backend\src\controllers\index.ts", "TypeScript", 0, 0, 23, 0, 0, 7, 8, 38
"c:\Users\Dodo\Desktop\Projeler\smartmoles-nest-backend\src\controllers\permission\permission.controller.ts", "TypeScript", 0, 0, 64, 0, 0, 0, 7, 71
"c:\Users\Dodo\Desktop\Projeler\smartmoles-nest-backend\src\controllers\permission\permissionGroup.controller.ts", "TypeScript", 0, 0, 68, 0, 0, 0, 7, 75
"c:\Users\Dodo\Desktop\Projeler\smartmoles-nest-backend\src\controllers\pumps\pumps.controller.ts", "TypeScript", 0, 0, 61, 0, 0, 0, 7, 68
"c:\Users\Dodo\Desktop\Projeler\smartmoles-nest-backend\src\controllers\qrCode.controller.ts", "TypeScript", 0, 0, 56, 0, 0, 0, 7, 63
"c:\Users\Dodo\Desktop\Projeler\smartmoles-nest-backend\src\controllers\subscription\subscription.controller.ts", "TypeScript", 0, 0, 88, 0, 0, 0, 12, 100
"c:\Users\Dodo\Desktop\Projeler\smartmoles-nest-backend\src\controllers\user.controller.ts", "TypeScript", 0, 0, 63, 0, 0, 9, 10, 82
"c:\Users\Dodo\Desktop\Projeler\smartmoles-nest-backend\src\controllers\userNew\usernew.controller.ts", "TypeScript", 0, 0, 98, 0, 0, 0, 14, 112
"c:\Users\Dodo\Desktop\Projeler\smartmoles-nest-backend\src\controllers\userSetting.controller.ts", "TypeScript", 0, 0, 59, 0, 0, 1, 8, 68
"c:\Users\Dodo\Desktop\Projeler\smartmoles-nest-backend\src\core\abstracts\data-services.abstract.ts", "TypeScript", 0, 0, 53, 0, 0, 0, 3, 56
"c:\Users\Dodo\Desktop\Projeler\smartmoles-nest-backend\src\core\abstracts\generic-repository.abstract.ts", "TypeScript", 0, 0, 7, 0, 0, 0, 5, 12
"c:\Users\Dodo\Desktop\Projeler\smartmoles-nest-backend\src\core\abstracts\index.ts", "TypeScript", 0, 0, 2, 0, 0, 0, 0, 2
"c:\Users\Dodo\Desktop\Projeler\smartmoles-nest-backend\src\core\dtos\callList.dto.ts", "TypeScript", 0, 0, 52, 0, 0, 0, 2, 54
"c:\Users\Dodo\Desktop\Projeler\smartmoles-nest-backend\src\core\dtos\card.dto.ts", "TypeScript", 0, 0, 73, 0, 0, 0, 3, 76
"c:\Users\Dodo\Desktop\Projeler\smartmoles-nest-backend\src\core\dtos\centralUnit\centralUnit.dto.ts", "TypeScript", 0, 0, 25, 0, 0, 0, 10, 35
"c:\Users\Dodo\Desktop\Projeler\smartmoles-nest-backend\src\core\dtos\centralUnit\hubGroups.dto.ts", "TypeScript", 0, 0, 23, 0, 0, 0, 6, 29
"c:\Users\Dodo\Desktop\Projeler\smartmoles-nest-backend\src\core\dtos\centralUnit\khas.dto.ts", "TypeScript", 0, 0, 35, 0, 0, 0, 3, 38
"c:\Users\Dodo\Desktop\Projeler\smartmoles-nest-backend\src\core\dtos\centralUnit\pumps-khas.dto.ts", "TypeScript", 0, 0, 12, 0, 0, 0, 3, 15
"c:\Users\Dodo\Desktop\Projeler\smartmoles-nest-backend\src\core\dtos\centralUnit\valveCard.dto.ts", "TypeScript", 0, 0, 18, 0, 0, 0, 3, 21
"c:\Users\Dodo\Desktop\Projeler\smartmoles-nest-backend\src\core\dtos\contracts\contractType.dto.ts", "TypeScript", 0, 0, 38, 0, 0, 0, 3, 41
"c:\Users\Dodo\Desktop\Projeler\smartmoles-nest-backend\src\core\dtos\contracts\user-contract.dto.ts", "TypeScript", 0, 0, 15, 0, 0, 0, 3, 18
"c:\Users\Dodo\Desktop\Projeler\smartmoles-nest-backend\src\core\dtos\hardwares\device-types.dto.ts", "TypeScript", 0, 0, 14, 0, 0, 0, 3, 17
"c:\Users\Dodo\Desktop\Projeler\smartmoles-nest-backend\src\core\dtos\hardwares\devices.dto.ts", "TypeScript", 0, 0, 18, 0, 0, 0, 3, 21
"c:\Users\Dodo\Desktop\Projeler\smartmoles-nest-backend\src\core\dtos\hardwares\hardwares.dto.ts", "TypeScript", 0, 0, 19, 0, 0, 0, 3, 22
"c:\Users\Dodo\Desktop\Projeler\smartmoles-nest-backend\src\core\dtos\hardwares\irrigation-types.dto.ts", "TypeScript", 0, 0, 21, 0, 0, 0, 3, 24
"c:\Users\Dodo\Desktop\Projeler\smartmoles-nest-backend\src\core\dtos\hardwares\modem.dto.ts", "TypeScript", 0, 0, 13, 0, 0, 0, 4, 17
"c:\Users\Dodo\Desktop\Projeler\smartmoles-nest-backend\src\core\dtos\hardwares\simcards.dto.ts", "TypeScript", 0, 0, 17, 0, 0, 0, 3, 20
"c:\Users\Dodo\Desktop\Projeler\smartmoles-nest-backend\src\core\dtos\index.ts", "TypeScript", 0, 0, 23, 0, 0, 7, 8, 38
"c:\Users\Dodo\Desktop\Projeler\smartmoles-nest-backend\src\core\dtos\logger\logger.dto.ts", "TypeScript", 0, 0, 9, 0, 0, 0, 2, 11
"c:\Users\Dodo\Desktop\Projeler\smartmoles-nest-backend\src\core\dtos\permissions\permission.dto.ts", "TypeScript", 0, 0, 14, 0, 0, 0, 3, 17
"c:\Users\Dodo\Desktop\Projeler\smartmoles-nest-backend\src\core\dtos\permissions\permissions-groups.dto.ts", "TypeScript", 0, 0, 23, 0, 0, 0, 3, 26
"c:\Users\Dodo\Desktop\Projeler\smartmoles-nest-backend\src\core\dtos\pumps\pumps.dto.ts", "TypeScript", 0, 0, 20, 0, 0, 0, 3, 23
"c:\Users\Dodo\Desktop\Projeler\smartmoles-nest-backend\src\core\dtos\qrCode.dto.ts", "TypeScript", 0, 0, 32, 0, 0, 0, 3, 35
"c:\Users\Dodo\Desktop\Projeler\smartmoles-nest-backend\src\core\dtos\subscription\subscription.dto.ts", "TypeScript", 0, 0, 47, 0, 0, 0, 3, 50
"c:\Users\Dodo\Desktop\Projeler\smartmoles-nest-backend\src\core\dtos\user.dto.ts", "TypeScript", 0, 0, 62, 0, 0, 4, 15, 81
"c:\Users\Dodo\Desktop\Projeler\smartmoles-nest-backend\src\core\dtos\users\users-new.dto.ts", "TypeScript", 0, 0, 61, 0, 0, 0, 2, 63
"c:\Users\Dodo\Desktop\Projeler\smartmoles-nest-backend\src\core\dtos\usersetting.dto.ts", "TypeScript", 0, 0, 31, 0, 0, 0, 2, 33
"c:\Users\Dodo\Desktop\Projeler\smartmoles-nest-backend\src\core\entities\callList.model.ts", "TypeScript", 0, 0, 15, 0, 0, 0, 1, 16
"c:\Users\Dodo\Desktop\Projeler\smartmoles-nest-backend\src\core\entities\card.model.ts", "TypeScript", 0, 0, 22, 0, 0, 0, 1, 23
"c:\Users\Dodo\Desktop\Projeler\smartmoles-nest-backend\src\core\entities\centralUnit\centralUnit.model.ts", "TypeScript", 0, 0, 11, 0, 0, 0, 9, 20
"c:\Users\Dodo\Desktop\Projeler\smartmoles-nest-backend\src\core\entities\centralUnit\hubGroups.model.ts", "TypeScript", 0, 0, 9, 0, 0, 0, 7, 16
"c:\Users\Dodo\Desktop\Projeler\smartmoles-nest-backend\src\core\entities\centralUnit\khas.model.ts", "TypeScript", 0, 0, 15, 0, 0, 0, 12, 27
"c:\Users\Dodo\Desktop\Projeler\smartmoles-nest-backend\src\core\entities\centralUnit\pumps-khas.model.ts", "TypeScript", 0, 0, 5, 0, 0, 0, 3, 8
"c:\Users\Dodo\Desktop\Projeler\smartmoles-nest-backend\src\core\entities\centralUnit\valveCard.model.ts", "TypeScript", 0, 0, 8, 0, 0, 0, 4, 12
"c:\Users\Dodo\Desktop\Projeler\smartmoles-nest-backend\src\core\entities\contracts\contractType.model.ts", "TypeScript", 0, 0, 16, 0, 0, 0, 2, 18
"c:\Users\Dodo\Desktop\Projeler\smartmoles-nest-backend\src\core\entities\contracts\user-contract.model.ts", "TypeScript", 0, 0, 8, 0, 0, 0, 2, 10
"c:\Users\Dodo\Desktop\Projeler\smartmoles-nest-backend\src\core\entities\hardwares\device-types.models.ts", "TypeScript", 0, 0, 6, 0, 0, 0, 1, 7
"c:\Users\Dodo\Desktop\Projeler\smartmoles-nest-backend\src\core\entities\hardwares\devices.model.ts", "TypeScript", 0, 0, 8, 0, 0, 0, 1, 9
"c:\Users\Dodo\Desktop\Projeler\smartmoles-nest-backend\src\core\entities\hardwares\hardwares.models.ts", "TypeScript", 0, 0, 8, 0, 0, 0, 1, 9
"c:\Users\Dodo\Desktop\Projeler\smartmoles-nest-backend\src\core\entities\hardwares\irrigation-types.model.ts", "TypeScript", 0, 0, 8, 0, 0, 0, 3, 11
"c:\Users\Dodo\Desktop\Projeler\smartmoles-nest-backend\src\core\entities\hardwares\modem.models.ts", "TypeScript", 0, 0, 6, 0, 0, 0, 4, 10
"c:\Users\Dodo\Desktop\Projeler\smartmoles-nest-backend\src\core\entities\hardwares\simcards.models.ts", "TypeScript", 0, 0, 8, 0, 0, 0, 3, 11
"c:\Users\Dodo\Desktop\Projeler\smartmoles-nest-backend\src\core\entities\index.ts", "TypeScript", 0, 0, 23, 0, 0, 7, 8, 38
"c:\Users\Dodo\Desktop\Projeler\smartmoles-nest-backend\src\core\entities\logger\logger.models.ts", "TypeScript", 0, 0, 9, 0, 0, 0, 1, 10
"c:\Users\Dodo\Desktop\Projeler\smartmoles-nest-backend\src\core\entities\permissions\permission-groups.models.ts", "TypeScript", 0, 0, 9, 0, 0, 0, 2, 11
"c:\Users\Dodo\Desktop\Projeler\smartmoles-nest-backend\src\core\entities\permissions\permission.model.ts", "TypeScript", 0, 0, 6, 0, 0, 0, 1, 7
"c:\Users\Dodo\Desktop\Projeler\smartmoles-nest-backend\src\core\entities\pumps\pumps.models.ts", "TypeScript", 0, 0, 9, 0, 0, 0, 2, 11
"c:\Users\Dodo\Desktop\Projeler\smartmoles-nest-backend\src\core\entities\qrCode.model.ts", "TypeScript", 0, 0, 9, 0, 0, 0, 1, 10
"c:\Users\Dodo\Desktop\Projeler\smartmoles-nest-backend\src\core\entities\subscription\subscription.models.ts", "TypeScript", 0, 0, 23, 0, 0, 0, 3, 26
"c:\Users\Dodo\Desktop\Projeler\smartmoles-nest-backend\src\core\entities\user.model.ts", "TypeScript", 0, 0, 14, 0, 0, 6, 3, 23
"c:\Users\Dodo\Desktop\Projeler\smartmoles-nest-backend\src\core\entities\users\users-new.models.ts", "TypeScript", 0, 0, 30, 0, 0, 0, 5, 35
"c:\Users\Dodo\Desktop\Projeler\smartmoles-nest-backend\src\core\entities\usersetting.model.ts", "TypeScript", 0, 0, 8, 0, 0, 0, 1, 9
"c:\Users\Dodo\Desktop\Projeler\smartmoles-nest-backend\src\core\index.ts", "TypeScript", 0, 0, 2, 0, 0, 0, 0, 2
"c:\Users\Dodo\Desktop\Projeler\smartmoles-nest-backend\src\environment\environment.ts", "TypeScript", 0, 0, 22, 0, 0, 0, 1, 23
"c:\Users\Dodo\Desktop\Projeler\smartmoles-nest-backend\src\environment\index.ts", "TypeScript", 0, 0, 1, 0, 0, 0, 1, 2
"c:\Users\Dodo\Desktop\Projeler\smartmoles-nest-backend\src\frameworks\data-services\mongo\model\callList.model.ts", "TypeScript", 0, 0, 32, 0, 0, 0, 4, 36
"c:\Users\Dodo\Desktop\Projeler\smartmoles-nest-backend\src\frameworks\data-services\mongo\model\card.model.ts", "TypeScript", 0, 0, 46, 0, 0, 0, 4, 50
"c:\Users\Dodo\Desktop\Projeler\smartmoles-nest-backend\src\frameworks\data-services\mongo\model\centralUnit\centralUnit.models.ts", "TypeScript", 0, 0, 24, 0, 0, 1, 5, 30
"c:\Users\Dodo\Desktop\Projeler\smartmoles-nest-backend\src\frameworks\data-services\mongo\model\centralUnit\hubGroups.model.ts", "TypeScript", 0, 0, 20, 0, 0, 1, 5, 26
"c:\Users\Dodo\Desktop\Projeler\smartmoles-nest-backend\src\frameworks\data-services\mongo\model\centralUnit\khas.model.ts", "TypeScript", 0, 0, 31, 0, 0, 1, 4, 36
"c:\Users\Dodo\Desktop\Projeler\smartmoles-nest-backend\src\frameworks\data-services\mongo\model\centralUnit\pumps-khas.model.ts", "TypeScript", 0, 0, 12, 0, 0, 1, 6, 19
"c:\Users\Dodo\Desktop\Projeler\smartmoles-nest-backend\src\frameworks\data-services\mongo\model\centralUnit\valveCard.model.ts", "TypeScript", 0, 0, 18, 0, 0, 1, 5, 24
"c:\Users\Dodo\Desktop\Projeler\smartmoles-nest-backend\src\frameworks\data-services\mongo\model\contracts\contractTypes.models.ts", "TypeScript", 0, 0, 34, 0, 0, 0, 4, 38
"c:\Users\Dodo\Desktop\Projeler\smartmoles-nest-backend\src\frameworks\data-services\mongo\model\contracts\user-contract-model.ts", "TypeScript", 0, 0, 16, 0, 0, 1, 4, 21
"c:\Users\Dodo\Desktop\Projeler\smartmoles-nest-backend\src\frameworks\data-services\mongo\model\hardwares\device-types.models.ts", "TypeScript", 0, 0, 15, 0, 0, 1, 4, 20
"c:\Users\Dodo\Desktop\Projeler\smartmoles-nest-backend\src\frameworks\data-services\mongo\model\hardwares\devices.models.ts", "TypeScript", 0, 0, 19, 0, 0, 1, 4, 24
"c:\Users\Dodo\Desktop\Projeler\smartmoles-nest-backend\src\frameworks\data-services\mongo\model\hardwares\hardwares.models.ts", "TypeScript", 0, 0, 19, 0, 0, 1, 4, 24
"c:\Users\Dodo\Desktop\Projeler\smartmoles-nest-backend\src\frameworks\data-services\mongo\model\hardwares\irrigation-types.model.ts", "TypeScript", 0, 0, 19, 0, 0, 1, 4, 24
"c:\Users\Dodo\Desktop\Projeler\smartmoles-nest-backend\src\frameworks\data-services\mongo\model\hardwares\modem.models.ts", "TypeScript", 0, 0, 14, 0, 0, 1, 4, 19
"c:\Users\Dodo\Desktop\Projeler\smartmoles-nest-backend\src\frameworks\data-services\mongo\model\hardwares\simcards.model.ts", "TypeScript", 0, 0, 17, 0, 0, 1, 4, 22
"c:\Users\Dodo\Desktop\Projeler\smartmoles-nest-backend\src\frameworks\data-services\mongo\model\index.ts", "TypeScript", 0, 0, 24, 0, 0, 8, 9, 41
"c:\Users\Dodo\Desktop\Projeler\smartmoles-nest-backend\src\frameworks\data-services\mongo\model\logger\logger.model.ts", "TypeScript", 0, 0, 20, 0, 0, 1, 4, 25
"c:\Users\Dodo\Desktop\Projeler\smartmoles-nest-backend\src\frameworks\data-services\mongo\model\permissions\permission-groups.model.ts", "TypeScript", 0, 0, 21, 0, 0, 1, 4, 26
"c:\Users\Dodo\Desktop\Projeler\smartmoles-nest-backend\src\frameworks\data-services\mongo\model\permissions\permission.model.ts", "TypeScript", 0, 0, 15, 0, 0, 1, 4, 20
"c:\Users\Dodo\Desktop\Projeler\smartmoles-nest-backend\src\frameworks\data-services\mongo\model\pumps\pumps.model.ts", "TypeScript", 0, 0, 21, 0, 0, 1, 4, 26
"c:\Users\Dodo\Desktop\Projeler\smartmoles-nest-backend\src\frameworks\data-services\mongo\model\qrCode.model.ts", "TypeScript", 0, 0, 20, 0, 0, 0, 4, 24
"c:\Users\Dodo\Desktop\Projeler\smartmoles-nest-backend\src\frameworks\data-services\mongo\model\subscription.model.ts\subscription.model.ts", "TypeScript", 0, 0, 48, 0, 0, 1, 4, 53
"c:\Users\Dodo\Desktop\Projeler\smartmoles-nest-backend\src\frameworks\data-services\mongo\model\user.model.ts", "TypeScript", 0, 0, 30, 0, 0, 0, 15, 45
"c:\Users\Dodo\Desktop\Projeler\smartmoles-nest-backend\src\frameworks\data-services\mongo\model\users\user-new.model.ts", "TypeScript", 0, 0, 61, 0, 0, 1, 4, 66
"c:\Users\Dodo\Desktop\Projeler\smartmoles-nest-backend\src\frameworks\data-services\mongo\model\usersetting.model.ts", "TypeScript", 0, 0, 18, 0, 0, 0, 3, 21
"c:\Users\Dodo\Desktop\Projeler\smartmoles-nest-backend\src\frameworks\data-services\mongo\mongo-data-services.module.ts", "TypeScript", 0, 0, 94, 0, 0, 0, 3, 97
"c:\Users\Dodo\Desktop\Projeler\smartmoles-nest-backend\src\frameworks\data-services\mongo\mongo-data-services.ts", "TypeScript", 0, 0, 191, 0, 0, 0, 4, 195
"c:\Users\Dodo\Desktop\Projeler\smartmoles-nest-backend\src\frameworks\data-services\mongo\mongo-generic-repository.ts", "TypeScript", 0, 0, 26, 0, 0, 0, 7, 33
"c:\Users\Dodo\Desktop\Projeler\smartmoles-nest-backend\src\libs\all-exception.filters.ts", "TypeScript", 0, 0, 12, 0, 0, 0, 2, 14
"c:\Users\Dodo\Desktop\Projeler\smartmoles-nest-backend\src\libs\api-results\standart-results.ts", "TypeScript", 0, 0, 31, 0, 0, 0, 3, 34
"c:\Users\Dodo\Desktop\Projeler\smartmoles-nest-backend\src\libs\middlewares\loggers\logger.middleware.ts", "TypeScript", 0, 0, 25, 0, 0, 0, 2, 27
"c:\Users\Dodo\Desktop\Projeler\smartmoles-nest-backend\src\main.ts", "TypeScript", 0, 0, 21, 0, 0, 1, 4, 26
"c:\Users\Dodo\Desktop\Projeler\smartmoles-nest-backend\src\operations\cronTest\cronTest.ts", "TypeScript", 0, 0, 11, 0, 0, 0, 3, 14
"c:\Users\Dodo\Desktop\Projeler\smartmoles-nest-backend\src\operations\cronTest\dynamicCron.ts", "TypeScript", 0, 0, 108, 0, 0, 0, 24, 132
"c:\Users\Dodo\Desktop\Projeler\smartmoles-nest-backend\src\operations\cronTest\testFunc.ts", "TypeScript", 0, 0, 23, 0, 0, 2, 6, 31
"c:\Users\Dodo\Desktop\Projeler\smartmoles-nest-backend\src\services\data-services.module.ts", "TypeScript", 0, 0, 7, 0, 0, 0, 2, 9
"c:\Users\Dodo\Desktop\Projeler\smartmoles-nest-backend\src\services\index.ts", "TypeScript", 0, 0, 23, 0, 0, 7, 8, 38
"c:\Users\Dodo\Desktop\Projeler\smartmoles-nest-backend\src\services\uses-cases\callList\callList-factory.service.ts", "TypeScript", 0, 0, 40, 0, 0, 4, 6, 50
"c:\Users\Dodo\Desktop\Projeler\smartmoles-nest-backend\src\services\uses-cases\callList\callList-services.module.ts", "TypeScript", 0, 0, 10, 0, 0, 0, 2, 12
"c:\Users\Dodo\Desktop\Projeler\smartmoles-nest-backend\src\services\uses-cases\callList\callList-services.service.ts", "TypeScript", 0, 0, 41, 0, 0, 0, 7, 48
"c:\Users\Dodo\Desktop\Projeler\smartmoles-nest-backend\src\services\uses-cases\card\card-factory.service.ts", "TypeScript", 0, 0, 54, 0, 0, 4, 6, 64
"c:\Users\Dodo\Desktop\Projeler\smartmoles-nest-backend\src\services\uses-cases\card\card-services.module.ts", "TypeScript", 0, 0, 10, 0, 0, 0, 3, 13
"c:\Users\Dodo\Desktop\Projeler\smartmoles-nest-backend\src\services\uses-cases\card\card-services.service.ts", "TypeScript", 0, 0, 37, 0, 0, 0, 8, 45
"c:\Users\Dodo\Desktop\Projeler\smartmoles-nest-backend\src\services\uses-cases\centralUnit\centralUnit-factory.service.ts", "TypeScript", 0, 0, 32, 0, 0, 0, 5, 37
"c:\Users\Dodo\Desktop\Projeler\smartmoles-nest-backend\src\services\uses-cases\centralUnit\centralUnit-service.module.ts", "TypeScript", 0, 0, 10, 0, 0, 0, 2, 12
"c:\Users\Dodo\Desktop\Projeler\smartmoles-nest-backend\src\services\uses-cases\centralUnit\centralUnit.service.ts", "TypeScript", 0, 0, 44, 0, 0, 0, 8, 52
"c:\Users\Dodo\Desktop\Projeler\smartmoles-nest-backend\src\services\uses-cases\centralUnit\hubGroup-factory.service.ts", "TypeScript", 0, 0, 28, 0, 0, 0, 5, 33
"c:\Users\Dodo\Desktop\Projeler\smartmoles-nest-backend\src\services\uses-cases\centralUnit\hubGroup-service.module.ts", "TypeScript", 0, 0, 10, 0, 0, 0, 2, 12
"c:\Users\Dodo\Desktop\Projeler\smartmoles-nest-backend\src\services\uses-cases\centralUnit\hubGroup.service.ts", "TypeScript", 0, 0, 37, 0, 0, 0, 8, 45
"c:\Users\Dodo\Desktop\Projeler\smartmoles-nest-backend\src\services\uses-cases\centralUnit\khas-factory.service.ts", "TypeScript", 0, 0, 36, 0, 0, 0, 5, 41
"c:\Users\Dodo\Desktop\Projeler\smartmoles-nest-backend\src\services\uses-cases\centralUnit\khas-service.module.ts", "TypeScript", 0, 0, 10, 0, 0, 0, 2, 12
"c:\Users\Dodo\Desktop\Projeler\smartmoles-nest-backend\src\services\uses-cases\centralUnit\khas.service.ts", "TypeScript", 0, 0, 41, 0, 0, 0, 10, 51
"c:\Users\Dodo\Desktop\Projeler\smartmoles-nest-backend\src\services\uses-cases\centralUnit\pumpKhas-factory.service.ts", "TypeScript", 0, 0, 24, 0, 0, 0, 5, 29
"c:\Users\Dodo\Desktop\Projeler\smartmoles-nest-backend\src\services\uses-cases\centralUnit\pumpKhas-service.module.ts", "TypeScript", 0, 0, 10, 0, 0, 0, 2, 12
"c:\Users\Dodo\Desktop\Projeler\smartmoles-nest-backend\src\services\uses-cases\centralUnit\pumpsKhas.service.ts", "TypeScript", 0, 0, 33, 0, 0, 0, 8, 41
"c:\Users\Dodo\Desktop\Projeler\smartmoles-nest-backend\src\services\uses-cases\centralUnit\valveCard-factory.module.ts", "TypeScript", 0, 0, 10, 0, 0, 0, 2, 12
"c:\Users\Dodo\Desktop\Projeler\smartmoles-nest-backend\src\services\uses-cases\centralUnit\valveCard-factory.service.ts", "TypeScript", 0, 0, 26, 0, 0, 0, 3, 29
"c:\Users\Dodo\Desktop\Projeler\smartmoles-nest-backend\src\services\uses-cases\centralUnit\valveCard.service.ts", "TypeScript", 0, 0, 40, 0, 0, 0, 9, 49
"c:\Users\Dodo\Desktop\Projeler\smartmoles-nest-backend\src\services\uses-cases\contracts\contractType-factory.service.ts", "TypeScript", 0, 0, 42, 0, 0, 0, 5, 47
"c:\Users\Dodo\Desktop\Projeler\smartmoles-nest-backend\src\services\uses-cases\contracts\contractType.module.ts", "TypeScript", 0, 0, 10, 0, 0, 0, 2, 12
"c:\Users\Dodo\Desktop\Projeler\smartmoles-nest-backend\src\services\uses-cases\contracts\contractType.service.ts", "TypeScript", 0, 0, 40, 0, 0, 0, 7, 47
"c:\Users\Dodo\Desktop\Projeler\smartmoles-nest-backend\src\services\uses-cases\contracts\userContract-factory.module.ts", "TypeScript", 0, 0, 10, 0, 0, 0, 2, 12
"c:\Users\Dodo\Desktop\Projeler\smartmoles-nest-backend\src\services\uses-cases\contracts\userContract-factory.service.ts", "TypeScript", 0, 0, 25, 0, 0, 0, 5, 30
"c:\Users\Dodo\Desktop\Projeler\smartmoles-nest-backend\src\services\uses-cases\contracts\userContract.service.ts", "TypeScript", 0, 0, 45, 0, 0, 0, 8, 53
"c:\Users\Dodo\Desktop\Projeler\smartmoles-nest-backend\src\services\uses-cases\hardwares\device-factory.service.ts", "TypeScript", 0, 0, 26, 0, 0, 0, 5, 31
"c:\Users\Dodo\Desktop\Projeler\smartmoles-nest-backend\src\services\uses-cases\hardwares\device.module.ts", "TypeScript", 0, 0, 10, 0, 0, 0, 1, 11
"c:\Users\Dodo\Desktop\Projeler\smartmoles-nest-backend\src\services\uses-cases\hardwares\deviceTypes-factory.service.ts", "TypeScript", 0, 0, 20, 0, 0, 0, 5, 25
"c:\Users\Dodo\Desktop\Projeler\smartmoles-nest-backend\src\services\uses-cases\hardwares\deviceTypes.module.ts", "TypeScript", 0, 0, 10, 0, 0, 0, 2, 12
"c:\Users\Dodo\Desktop\Projeler\smartmoles-nest-backend\src\services\uses-cases\hardwares\deviceTypes.service.ts", "TypeScript", 0, 0, 30, 0, 0, 0, 7, 37
"c:\Users\Dodo\Desktop\Projeler\smartmoles-nest-backend\src\services\uses-cases\hardwares\devices.service.ts", "TypeScript", 0, 0, 32, 0, 0, 0, 7, 39
"c:\Users\Dodo\Desktop\Projeler\smartmoles-nest-backend\src\services\uses-cases\hardwares\hardwares-factory.service.ts", "TypeScript", 0, 0, 26, 0, 0, 0, 5, 31
"c:\Users\Dodo\Desktop\Projeler\smartmoles-nest-backend\src\services\uses-cases\hardwares\hardwares.module.ts", "TypeScript", 0, 0, 10, 0, 0, 0, 2, 12
"c:\Users\Dodo\Desktop\Projeler\smartmoles-nest-backend\src\services\uses-cases\hardwares\hardwares.service.ts", "TypeScript", 0, 0, 30, 0, 0, 0, 7, 37
"c:\Users\Dodo\Desktop\Projeler\smartmoles-nest-backend\src\services\uses-cases\hardwares\irrigationTypes-factory.service.ts", "TypeScript", 0, 0, 27, 0, 0, 0, 5, 32
"c:\Users\Dodo\Desktop\Projeler\smartmoles-nest-backend\src\services\uses-cases\hardwares\irrigationTypes.module.ts", "TypeScript", 0, 0, 10, 0, 0, 0, 2, 12
"c:\Users\Dodo\Desktop\Projeler\smartmoles-nest-backend\src\services\uses-cases\hardwares\irrigationTypes.service.ts", "TypeScript", 0, 0, 42, 0, 0, 0, 7, 49
"c:\Users\Dodo\Desktop\Projeler\smartmoles-nest-backend\src\services\uses-cases\hardwares\modem-factory.service.ts", "TypeScript", 0, 0, 20, 0, 0, 0, 4, 24
"c:\Users\Dodo\Desktop\Projeler\smartmoles-nest-backend\src\services\uses-cases\hardwares\modem.module.ts", "TypeScript", 0, 0, 10, 0, 0, 0, 2, 12
"c:\Users\Dodo\Desktop\Projeler\smartmoles-nest-backend\src\services\uses-cases\hardwares\modem.service.ts", "TypeScript", 0, 0, 33, 0, 0, 0, 8, 41
"c:\Users\Dodo\Desktop\Projeler\smartmoles-nest-backend\src\services\uses-cases\hardwares\simCard-factory.service.ts", "TypeScript", 0, 0, 24, 0, 0, 0, 5, 29
"c:\Users\Dodo\Desktop\Projeler\smartmoles-nest-backend\src\services\uses-cases\hardwares\simCards.module.ts", "TypeScript", 0, 0, 10, 0, 0, 0, 2, 12
"c:\Users\Dodo\Desktop\Projeler\smartmoles-nest-backend\src\services\uses-cases\hardwares\simCards.service.ts", "TypeScript", 0, 0, 38, 0, 0, 0, 8, 46
"c:\Users\Dodo\Desktop\Projeler\smartmoles-nest-backend\src\services\uses-cases\logger\logger-factory.service.ts", "TypeScript", 0, 0, 16, 0, 0, 0, 3, 19
"c:\Users\Dodo\Desktop\Projeler\smartmoles-nest-backend\src\services\uses-cases\logger\logger.module.ts", "TypeScript", 0, 0, 10, 0, 0, 0, 2, 12
"c:\Users\Dodo\Desktop\Projeler\smartmoles-nest-backend\src\services\uses-cases\logger\logger.service.ts", "TypeScript", 0, 0, 18, 0, 0, 0, 4, 22
"c:\Users\Dodo\Desktop\Projeler\smartmoles-nest-backend\src\services\uses-cases\permissions\permission-factory.service.ts", "TypeScript", 0, 0, 24, 0, 0, 0, 5, 29
"c:\Users\Dodo\Desktop\Projeler\smartmoles-nest-backend\src\services\uses-cases\permissions\permission.module.ts", "TypeScript", 0, 0, 10, 0, 0, 0, 3, 13
"c:\Users\Dodo\Desktop\Projeler\smartmoles-nest-backend\src\services\uses-cases\permissions\permission.service.ts", "TypeScript", 0, 0, 35, 0, 0, 0, 8, 43
"c:\Users\Dodo\Desktop\Projeler\smartmoles-nest-backend\src\services\uses-cases\permissions\permissionGroups-factory.service.ts", "TypeScript", 0, 0, 31, 0, 0, 0, 5, 36
"c:\Users\Dodo\Desktop\Projeler\smartmoles-nest-backend\src\services\uses-cases\permissions\permissionGroups.module.ts", "TypeScript", 0, 0, 10, 0, 0, 0, 2, 12
"c:\Users\Dodo\Desktop\Projeler\smartmoles-nest-backend\src\services\uses-cases\permissions\permissionGroups.service.ts", "TypeScript", 0, 0, 42, 0, 0, 0, 7, 49
"c:\Users\Dodo\Desktop\Projeler\smartmoles-nest-backend\src\services\uses-cases\pumps\pumps-factory.service.ts", "TypeScript", 0, 0, 26, 0, 0, 0, 5, 31
"c:\Users\Dodo\Desktop\Projeler\smartmoles-nest-backend\src\services\uses-cases\pumps\pumps.module.ts", "TypeScript", 0, 0, 10, 0, 0, 0, 2, 12
"c:\Users\Dodo\Desktop\Projeler\smartmoles-nest-backend\src\services\uses-cases\pumps\pumps.service.ts", "TypeScript", 0, 0, 33, 0, 0, 0, 7, 40
"c:\Users\Dodo\Desktop\Projeler\smartmoles-nest-backend\src\services\uses-cases\qrCode\qrCode-factory.service.ts", "TypeScript", 0, 0, 28, 0, 0, 4, 6, 38
"c:\Users\Dodo\Desktop\Projeler\smartmoles-nest-backend\src\services\uses-cases\qrCode\qrCode-services.module.ts", "TypeScript", 0, 0, 10, 0, 0, 0, 3, 13
"c:\Users\Dodo\Desktop\Projeler\smartmoles-nest-backend\src\services\uses-cases\qrCode\qrCode-services.service.ts", "TypeScript", 0, 0, 41, 0, 0, 0, 9, 50
"c:\Users\Dodo\Desktop\Projeler\smartmoles-nest-backend\src\services\uses-cases\subscription\subscription-factory.service.ts", "TypeScript", 0, 0, 55, 0, 0, 0, 5, 60
"c:\Users\Dodo\Desktop\Projeler\smartmoles-nest-backend\src\services\uses-cases\subscription\subscription.module.ts", "TypeScript", 0, 0, 10, 0, 0, 0, 2, 12
"c:\Users\Dodo\Desktop\Projeler\smartmoles-nest-backend\src\services\uses-cases\subscription\subscription.service.ts", "TypeScript", 0, 0, 68, 0, 0, 0, 12, 80
"c:\Users\Dodo\Desktop\Projeler\smartmoles-nest-backend\src\services\uses-cases\userNew\userNew-factory.service.ts", "TypeScript", 0, 0, 56, 0, 0, 0, 5, 61
"c:\Users\Dodo\Desktop\Projeler\smartmoles-nest-backend\src\services\uses-cases\userNew\userNew.module.ts", "TypeScript", 0, 0, 10, 0, 0, 0, 2, 12
"c:\Users\Dodo\Desktop\Projeler\smartmoles-nest-backend\src\services\uses-cases\userNew\userNew.service.ts", "TypeScript", 0, 0, 84, 0, 0, 3, 14, 101
"c:\Users\Dodo\Desktop\Projeler\smartmoles-nest-backend\src\services\uses-cases\user\user-factory.service.ts", "TypeScript", 0, 0, 34, 0, 0, 12, 5, 51
"c:\Users\Dodo\Desktop\Projeler\smartmoles-nest-backend\src\services\uses-cases\user\user-services.module.ts", "TypeScript", 0, 0, 10, 0, 0, 0, 1, 11
"c:\Users\Dodo\Desktop\Projeler\smartmoles-nest-backend\src\services\uses-cases\user\user-services.service.ts", "TypeScript", 0, 0, 29, 0, 0, 11, 10, 50
"c:\Users\Dodo\Desktop\Projeler\smartmoles-nest-backend\src\services\uses-cases\usersetting\usersetting-factory.service.ts", "TypeScript", 0, 0, 26, 0, 0, 4, 6, 36
"c:\Users\Dodo\Desktop\Projeler\smartmoles-nest-backend\src\services\uses-cases\usersetting\usersetting-services.module.ts", "TypeScript", 0, 0, 10, 0, 0, 0, 3, 13
"c:\Users\Dodo\Desktop\Projeler\smartmoles-nest-backend\src\services\uses-cases\usersetting\usersetting-services.service.ts", "TypeScript", 0, 0, 41, 0, 0, 0, 7, 48
"c:\Users\Dodo\Desktop\Projeler\smartmoles-nest-backend\test\app.e2e-spec.ts", "TypeScript", 0, 0, 20, 0, 0, 0, 5, 25
"c:\Users\Dodo\Desktop\Projeler\smartmoles-nest-backend\test\jest-e2e.json", "JSON", 0, 0, 0, 9, 0, 0, 1, 10
"c:\Users\Dodo\Desktop\Projeler\smartmoles-nest-backend\tsconfig.build.json", "JSON", 0, 0, 0, 3, 0, 2, 0, 5
"c:\Users\Dodo\Desktop\Projeler\smartmoles-nest-backend\tsconfig.json", "JSON with Comments", 21, 0, 0, 0, 0, 0, 1, 22
"Total", "-", 21, 24, 5935, 17120, 51, 137, 992, 24280