"filename", "language", "TypeScript", "JSON", "comment", "blank", "total"
"c:\Users\Dodo\Desktop\Projeler\smartmoles-nest-backend\package-lock.json", "JSON", 0, 712, 0, 0, 712
"c:\Users\Dodo\Desktop\Projeler\smartmoles-nest-backend\package.json", "JSON", 0, 2, 0, 0, 2
"c:\Users\Dodo\Desktop\Projeler\smartmoles-nest-backend\src\app.module.ts", "TypeScript", 24, 0, 0, 0, 24
"c:\Users\Dodo\Desktop\Projeler\smartmoles-nest-backend\src\core\dtos\centralUnit\hubGroups.dto.ts", "TypeScript", 4, 0, 0, 4, 8
"c:\Users\Dodo\Desktop\Projeler\smartmoles-nest-backend\src\core\entities\centralUnit\hubGroups.model.ts", "TypeScript", 2, 0, 0, 2, 4
"c:\Users\Dodo\Desktop\Projeler\smartmoles-nest-backend\src\environment\environment-iterator.ts", "TypeScript", 8, 0, 0, 3, 11
"c:\Users\Dodo\Desktop\Projeler\smartmoles-nest-backend\src\environment\environment.ts", "TypeScript", 5, 0, 0, 1, 6
"c:\Users\Dodo\Desktop\Projeler\smartmoles-nest-backend\src\frameworks\data-services\mongo\model\centralUnit\hubGroups.model.ts", "TypeScript", 2, 0, 0, 2, 4
"c:\Users\Dodo\Desktop\Projeler\smartmoles-nest-backend\src\libs\middlewares\loggers\winston-logger.middleware.ts", "TypeScript", 0, 0, 0, 1, 1
"c:\Users\Dodo\Desktop\Projeler\smartmoles-nest-backend\src\main.ts", "TypeScript", 0, 0, 0, 1, 1
"c:\Users\Dodo\Desktop\Projeler\smartmoles-nest-backend\src\operations\hubGroups\hubControl.ts", "TypeScript", 84, 0, 3, 7, 94
"c:\Users\Dodo\Desktop\Projeler\smartmoles-nest-backend\src\services\uses-cases\centralUnit\hubGroup-factory.service.ts", "TypeScript", 4, 0, 0, 0, 4
"c:\Users\Dodo\Desktop\Projeler\smartmoles-nest-backend\src\services\uses-cases\logger\logger-factory.service.ts", "TypeScript", 1, 0, 0, 0, 1
"Total", "-", 134, 714, 3, 21, 872