"filename", "language", "JSON", "TypeScript", "comment", "blank", "total"
"c:\Users\Dodo\Desktop\Projeler\smartmoles-nest-backend\package-lock.json", "JSON", 4, 0, 0, 0, 4
"c:\Users\Dodo\Desktop\Projeler\smartmoles-nest-backend\package.json", "JSON", 16, 0, 0, 0, 16
"c:\Users\Dodo\Desktop\Projeler\smartmoles-nest-backend\src\app.module.ts", "TypeScript", 0, 2, 0, 1, 3
"c:\Users\Dodo\Desktop\Projeler\smartmoles-nest-backend\src\core\dtos\centralUnit\centralUnit.dto.ts", "TypeScript", 0, 22, 0, 9, 31
"c:\Users\Dodo\Desktop\Projeler\smartmoles-nest-backend\src\core\dtos\centralUnit\hubGroups.dto.ts", "TypeScript", 0, 20, 0, 5, 25
"c:\Users\Dodo\Desktop\Projeler\smartmoles-nest-backend\src\core\dtos\centralUnit\khas.dto.ts", "TypeScript", 0, 26, 0, 2, 28
"c:\Users\Dodo\Desktop\Projeler\smartmoles-nest-backend\src\core\entities\centralUnit\centralUnit.model.ts", "TypeScript", 0, 0, 0, 2, 2
"c:\Users\Dodo\Desktop\Projeler\smartmoles-nest-backend\src\core\entities\index.ts", "TypeScript", 0, 1, 1, 1, 3
"c:\Users\Dodo\Desktop\Projeler\smartmoles-nest-backend\src\environment\environment.ts", "TypeScript", 0, 19, 0, 2, 21
"c:\Users\Dodo\Desktop\Projeler\smartmoles-nest-backend\src\main.ts", "TypeScript", 0, 1, 0, 0, 1
"c:\Users\Dodo\Desktop\Projeler\smartmoles-nest-backend\src\operations\cronTest\dynamicCron.ts", "TypeScript", 0, -84, 88, 1, 5
"c:\Users\Dodo\Desktop\Projeler\smartmoles-nest-backend\src\operations\hubGroups\hubControl.ts", "TypeScript", 0, 136, 18, 14, 168
"c:\Users\Dodo\Desktop\Projeler\smartmoles-nest-backend\src\services\uses-cases\centralUnit\hubGroup.service.ts", "TypeScript", 0, 10, 0, 1, 11
"c:\Users\Dodo\Desktop\Projeler\smartmoles-nest-backend\src\services\uses-cases\pumps\pumps.service.ts", "TypeScript", 0, -1, 0, 0, -1
"c:\Users\Dodo\Desktop\Projeler\smartmoles-nest-backend\src\services\uses-cases\usersetting\usersetting-services.service.ts", "TypeScript", 0, 3, 0, 0, 3
"Total", "-", 20, 155, 107, 38, 320