"filename", "language", "JSON", "TypeScript", "comment", "blank", "total"
"c:\Users\Dodo\Desktop\Projeler\smartmoles-nest-backend\package-lock.json", "JSON", 79, 0, 0, 0, 79
"c:\Users\Dodo\Desktop\Projeler\smartmoles-nest-backend\package.json", "JSON", 1, 0, 0, 0, 1
"c:\Users\Dodo\Desktop\Projeler\smartmoles-nest-backend\src\app.module.ts", "TypeScript", 0, 11, 0, 1, 12
"c:\Users\Dodo\Desktop\Projeler\smartmoles-nest-backend\src\controllers\card.controller.ts", "TypeScript", 0, 12, 0, 3, 15
"c:\Users\Dodo\Desktop\Projeler\smartmoles-nest-backend\src\core\dtos\centralUnit\hubGroups.dto.ts", "TypeScript", 0, 6, 0, 2, 8
"c:\Users\Dodo\Desktop\Projeler\smartmoles-nest-backend\src\core\dtos\centralUnit\khas.dto.ts", "TypeScript", 0, 12, 2, 0, 14
"c:\Users\Dodo\Desktop\Projeler\smartmoles-nest-backend\src\core\dtos\centralUnit\valveCard.dto.ts", "TypeScript", 0, 32, 0, 1, 33
"c:\Users\Dodo\Desktop\Projeler\smartmoles-nest-backend\src\core\dtos\pumps\pumps.dto.ts", "TypeScript", 0, 12, 0, 0, 12
"c:\Users\Dodo\Desktop\Projeler\smartmoles-nest-backend\src\core\entities\centralUnit\hubGroups.model.ts", "TypeScript", 0, 1, 0, 1, 2
"c:\Users\Dodo\Desktop\Projeler\smartmoles-nest-backend\src\core\entities\centralUnit\khas.model.ts", "TypeScript", 0, 3, 3, 3, 9
"c:\Users\Dodo\Desktop\Projeler\smartmoles-nest-backend\src\core\entities\centralUnit\valveCard.model.ts", "TypeScript", 0, 8, 0, 8, 16
"c:\Users\Dodo\Desktop\Projeler\smartmoles-nest-backend\src\core\entities\pumps\pumps.models.ts", "TypeScript", 0, 6, 0, 0, 6
"c:\Users\Dodo\Desktop\Projeler\smartmoles-nest-backend\src\frameworks\data-services\mongo\model\centralUnit\hubGroups.model.ts", "TypeScript", 0, 2, 0, 2, 4
"c:\Users\Dodo\Desktop\Projeler\smartmoles-nest-backend\src\frameworks\data-services\mongo\model\centralUnit\khas.model.ts", "TypeScript", 0, 6, 1, 0, 7
"c:\Users\Dodo\Desktop\Projeler\smartmoles-nest-backend\src\frameworks\data-services\mongo\model\centralUnit\valveCard.model.ts", "TypeScript", 0, 16, 0, 1, 17
"c:\Users\Dodo\Desktop\Projeler\smartmoles-nest-backend\src\frameworks\data-services\mongo\model\pumps\pumps.model.ts", "TypeScript", 0, 12, 0, 0, 12
"c:\Users\Dodo\Desktop\Projeler\smartmoles-nest-backend\src\operations\hubGroups\hubControl.ts", "TypeScript", 0, 94, 26, 11, 131
"c:\Users\Dodo\Desktop\Projeler\smartmoles-nest-backend\src\services\uses-cases\card\card-services.module.ts", "TypeScript", 0, 13, 0, -1, 12
"c:\Users\Dodo\Desktop\Projeler\smartmoles-nest-backend\src\services\uses-cases\card\card-services.service.ts", "TypeScript", 0, 19, 0, 3, 22
"c:\Users\Dodo\Desktop\Projeler\smartmoles-nest-backend\src\services\uses-cases\centralUnit\hubGroup-factory.service.ts", "TypeScript", 0, 2, 0, 0, 2
"c:\Users\Dodo\Desktop\Projeler\smartmoles-nest-backend\src\services\uses-cases\centralUnit\khas-factory.service.ts", "TypeScript", 0, 8, 0, 0, 8
"c:\Users\Dodo\Desktop\Projeler\smartmoles-nest-backend\src\services\uses-cases\centralUnit\valveCard-factory.service.ts", "TypeScript", 0, 16, 0, 0, 16
"Total", "-", 80, 291, 32, 35, 438